NO textures/no.xpm
SO textures/so.xpm
WE textures/we.xpm
EA textures/ea.xpm
F 
C 0,10,-10

11111111111
10000100001
10000000001
11000N00011
10000000001
10000100001
11111111111
