NO textures/no.xpm  SO textures/so.xpm      WE textures/we.xpm
EA textures/ea.xpm
F 184,113,39
C 51,198,227

11111111111
10000100001
10000000001
14000N00021
10000000001
10000300001
11111111111