1 1 1 1 1 1 1 1 1
11111111111111111
11010101010100111
10000N00000000001
10101010101010111
11111111111111111
1 1 1 1 1 1 1 1 1