NO textures/no.xpm  SO textures/so.xpm      WE textures/we.xpm
C 51,198,227

F 184,113,39

1 1 1 1 1 1 1 1 1
11111111111111111
11010101010100111
10000E00000000001
10101010101010111
11111111111111111
1 1 1 1 1 1 1 1 1
