NO textures/so.xpm  SO textures/so.xpm      WE textures/so.xpm
C 51,198,227
EA textures/so.xpm
F 184,113,39

1 1 1 1 1 1 1 1 1
11111111111111111
10000E00000000001
11111111111111111
1 1 1 1 1 1 1 1 1
