NO textures/no.xpm
SO textures/so.xpm
WE textures/we.xpm
EA textures/ea.xpm
F 184,113,39
C 51,198,227

1111111111111111111
1000000000000000001
1000000000001100001
1000000000000000001
1000011111111100001
100001       111101
100001 1111     10111111
100001 1001     100000011
100001 1001     100001001
100001 1001     100001111
100001 1001     100001
100001 1111     101111
100001       111101
1000011111111100001
100000000000000W001
1000000000000000001
1111111111111111111
