111111111
1000000001
111111111


#人によって、有効にするかどうか別れる。