                    111111111111111
                    100000000000001
                    100000111000001
                    100001  1000001
                    10001   1000001
                    1001    1000001
                    111     1000001
                            1000001
              1111111       1000001
             10000001       1000001
            10000001        1000001
           10000001         1000001
          10000001          100001
         10000001          100001
        10000001          100001
       10000001          100001
      10000001          100001
     100000011111111111100001
    100000000000000000000001    1
    100000000000000000000001   101
    111111111110000000000001  1001
               1000000000001 10001
               100000N000001100001
               1000000000000000001
               1000011111111111111
               100001
               100001
               111111
