NO textures/no.xpm
SO textures/so.xpm
WE textures/we.xpm
EA textures/ea.xpm
F 184,113,39
C 51,198,227

                    111111111111111
                    100000000000001
                    100001111000001
                    100011  1000001
                    10011   1000001
                    1011    1000001
                    111     1000001
                            1000001
             11111111       1000001
            110000001       1000001
           1100000011       1000001
          1100000011        1000011
         1100000011         100011
        1100000011         110011
       1100000011         110011
      1100000011         110011
     1100000011         110011
    1100000011111111111110011
    100000000000000000000001    1
    100000000000000000000001   111
    111111111111000000000001  1101
               1000000000001 11001
               100000E000001110001
               1000000000000000001
               1000011111111111111
               100001
               100001
               111111