1111111111111111111
1000000000000000001
1000000000000000001
1000011111111100001
100001       100001
100001       100001
100001       100001
100001       100001
100001       100001
100001       100001
100001       100001
1000011111111100001
100000000000000N001
1000000000000000001
1111111111111111111