NO textures/ja_no.xpm
SO textures/ja_so.xpm
WE textures/ja_we.xpm
EA textures/ja_ea.xpm
F 184,113,39
C 51,198,227

1111111111111111111
1000000001100011101
1010111000001000001
1110001011111001101
1000000001100011101
1000100001000110101
1000010N01000010101
1000100001000100101
1101001011000000001
1101000000000000001
1111111111111111111