NO textures/so.xpm
SO textures/so.xpm
WE textures/so.xpm
EA textures/so.xpm
C 51,198,227
F 184,113,39

111111111
100000001
101000001
1010N0001
100110001
100000001
100000001
111111111
