NO textures/backroom_wall.xpm
SO textures/backroom_wall.xpm
WE textures/backroom_wall.xpm
EA textures/backroom_wall.xpm
F 124,108,75
C 124,108,75

1111111111111
1000000000001
1001001001001
1000000000001
1001001001001
1E00000000001
1001001001001
1000000000001
1001001001001
1000000000001
1001001001001
1000000000001
1111111111111
