1111111111111111
0000000000000001
1000000000000N01
1111111111111111