NO textures/no.xpm
SO textures/so.xpm
WE textures/we.xpm
EA textures/ea.xpm
F 184,113,39
C 51,198,227

1111111111111111
N000000000000001
1000000000000N01
1111111111111111