1111111111111111
1000000000000001
1000000000000N01
11N1111111111111