1111111111111111
1000011000000001
1000000000000N0001
1111111111111111