NO textures/no.xpm
SO textures/so.xpm
WE textures/we.xpm
EA textures/ea.xpm
F 184,113,39
C 51,198,227

111111111
100000001
1000N0001
10S0000E1
111111111