111111111
100000001
1000N0001
10S000001
111111111